can = 参数
cha = 查
che = 车
chang = 厂
cheng = 名称
chuan=上传
da = 大
dan = 单位
de = 的
di = 提交,地
du = 经度,纬度,度量
fou = 否
hang = 行业
he = 核,合,和
hua = 计划
hui = 社会
jia = 价
jia = 家,评价
jian = 见
jun = 均匀
lv =速率
pi = 否极泰来,匹配
qi = 其,期
qu = 区
se = 颜色
sheng = 省
shu = 属,数,技术
ti = 体
wu = 无
xi = 联系
xin= 信
xing = 反省
yuan = 员
zhong = 种类,重点,重金属
mi = 秘密


